11
0 1 5 0 0 0 0 0 0 0 0
1 0 0 0 3 4 1 0 0 0 0
5 0 0 6 0 0 0 0 0 0 0
0 0 6 0 0 3 0 0 0 0 0
0 0 0 0 0 2 1 0 0 0 0
5 0 3 3 2 0 0 0 0 0 0
0 1 0 0 1 0 0 0 0 0 0
0 0 0 0 0 0 0 0 1 2 6
0 0 0 0 0 0 0 1 0 3 0
0 0 0 0 0 0 0 2 3 0 1
0 0 0 0 0 0 0 6 0 1 0
